+-+-+-+-+
|   |   |
+ +-+ + +
|   | | |
+ +-+-+ +
|   |   |
+-+ + +-+
|     | |
+ +-+-+ +
|     | |
+ + +-+ +
| | | | |
+-+ + + +
| |   | |
+ + + + +
|   |   |
+-+-+ + +
|   | | |
+-+ + +-+
|       |
+-+-+-+-+
